...........................
...........................
....@@@@@@@@@@@@@@@@@@@....
...........................
...........................
...........................
...........................
....@@@@@@@@@@@@@@@@@@@....
....@.................@....
....@.................@....
....@.................@....
....@.................@....
....@@@@@@@@@@@@@@@@@@@....
...........................
...........................
...........................
...........................
....@@@@@@@@@@@@@@@@@@@....
...........................
...........................