...........................
...........................
....@@@@@@@@@@@@@@@@@@@....
....@.................@....
....@.................@....
....@..@@@@@@@@@@@@@..@....
....@..@...........@..@....
....@..@...........@..@....
....@..@..@@@@@@@..@..@....
....@..@..@.....@..@..@....
....@..@..@.....@..@..@....
....@..@..@@@@@@@..@..@....
....@..@...........@..@....
....@..@...........@..@....
....@..@@@@@@@@@@@@@..@....
....@.................@....
....@.................@....
....@@@@@@@@@@@@@@@@@@@....
...........................
...........................