...........................
...........................
...........................
....@@@@@@@...........@....
......................@....
......................@....
......................@....
.......@@@@@@@........@....
......................@....
......................@....
......................@....
......................@....
....@@@@@@@...........@....
......................@....
......................@....
......................@....
.......@@@@@@@........@....
......................@....
...........................
...........................